Adam Tallman	ajrtallman@utexas.edu	E1
Alex Rosenfeld	alexbrosenfeld@gmail.com	
Ambrocio Gutierrez Lorenzo	N/A	W5
Christopher Brown	chrisbrown@utexas.edu	W7
Cornelia Loos	cornelia.loos@utexas.edu	E12
Cristian Juarez	cristianrj@utexas.edu	A3
Daniel Valle Arevalo	davalle@utexas.edu	W3
Ekaterina Levina	ekaterina.levina@utexas.edu	A1
Elena Liskova	eliskova@utexas.edu	
Elisa Ferracane	elisa@ferracane.com	A2
Eric Adell	adell@utexas.edu	
Eric Holgate	holgate@utexas.edu	W9
Frances Cooley	cooley.frances@utexas.edu	E7
Gladys Camacho Rios	N/A	W11
Grace Neveu	graceneveu@utexas.edu	E11
Hammal Al Bulushi	hammal@utexas.edu	E10
Jaime Perez Gonzalez	locosingo@hotmail.com	
Jungsoo Kim	jungsookim@utexas.edu	W10
Justin Cope	justin.cope@utexas.edu	
Justin Power	justin.power@utexas.edu	E2
Kate Mesh	kate.a.mesh@gmail.com	E3
Kirsten Meeman	N/A	W8
Kristin Denlinger	N/A	E6
Kyle Jerro	jerrokyle@gmail.com	
Laura Faircloth	laura.faircloth1693@gmail.com	W12
Lorena Orjuela	N/A	W4
Luke Pinette	lkpinette@utexas.edu	E4
Maria del Mar Bassa Varnell	mbassa@mail.utexas.edu	
Manu Agarwal	N/A	W1
Michael Everdell	everdellm@utexas.edu	W2
Natalia Bermudez	nataliabermudez@utexas.edu	
Qianping Gu	qiangping.gu@utexas.edu	E8
Sandie Keerstock	keerstock@utexas.edu	E9
Santiago Gualapuro Gualapuro	N/A	W6
Su Wang	shrekwang@utexas.edu	E5
Tammi Stout	stoutt@utexas.edu	W13
Dr. Helen Aristar-Dry	hdry@linguistlist.org	4.426
Dr. Alex Teodorescu	alex.teodorescu@gmail.com	4.428
Dr. Suzanne van der Feest	suzanne@austin.utexas.edu	4.430
Dr. Danny Law	dannylaw@austin.utexas.edu	4.432
Dr. Steve Wechsler	wechsler@austin.utexas.edu	4.702
Dr. Hans Kamp	hanskamp@austin.utexas.edu	4.704
Dr. John Beavers	jtbeavers@utexas.edu	4.706
Dr. David Beaver	dib@utexas.edu	4.708
Dr. Megan Crowhurst	mcrowhurst@mail.utexas.edu	4.712
Dr. David Quinto-Pozos	davidqp@austin.utexas.edu	4.714
Liz Myrick	lmyrick@austin.utexas.edu	4.718
Dr. Richard Meier	rmeier@austin.utexas.edu	4.720
Dr. Rajka Smiljanic	rajka@mail.utexas.edu	4.724
Dr. Scott Myers	s.myers@mail.utexas.edu	4.726
Dr. Tony Woodbury	woodbury@austin.utexas.edu	4.728
Dr. Harvey Sussman	sussman@austin.utexas.edu	4.730
Dr. Nora England	nengland@austin.utexas.edu	4.732
Dr. Katrin Erk	katrin.erk@mail.utexas.edu	4.734
Dr. Pattie Epps	pattieepps@austin.utexas.edu	4.736
Dr. Jason Baldridge	jbaldrid@mail.utexas.edu	4.738
		4.618
Debbie White	debbiewhiteasl@gmail.com	4.620
Franky Schussel	franky-ramont@utexas.edu	4.622
David Simmons	david.simmons@utexas.edu	4.624
Michael Wynne	mwynnejr@mac.com	4.626
Cynthia Gladstone	c.gladstone@austin.utexas.edu	4.304C
Ben Rapstine	rapstine@austin.utexas.edu	4.304D
Gabrielle Deville	gdeville@austin.utexas.edu	4.304
